_______________________________________________________________________________________1111111111111111111111111111111__________________________________________111111__1111111111111111____11111_____________________________________________________________11_1111_1_____1___________________11__________
_________________________________________________________________________________________11111111111111111111111111111_________________________________________1111111111111111111111111___11111______________________________________________________________11_11_1_______1_11_________________11________1
1______________________1_________________________________________________________________11111111111_11_11111111111111_________________________________________111111111111111111111111___111111_________________________________________________________________1_111_1____1_11__________________1_______11
1________________________1________________________________________________________________111111111__11111111111111111__________________________________________1111111_11111111111111____111111_____________________________________________________________111___1_1_11____111__________________1______11_
_________________________1________________________________________________________________1111111111__1111111111111111____________________________________________1111111111111111111_____111111____________________________________________________________1__1_11111_1___111_1_________________________11_
1____1_____________________________________________________________________________________1111111__11111111111111111____________________________________________1111111_111111111111_____111111_________________________________________________________________11_11_11___1_11__________________11________
_1__________________________________________________________________________________________111111__11111111111111111_____________________________________________1111111_1111111111______11111_____________________________________________________________11_1___1_11_11_11_1_1__________________1______1_
___________________________________________________________________________________________1_1111_1_1_111111111111111____________________________________________1_1111__11111111111_______1111______11_____________________________________________________1_1111_____1_1_1_1111_____________1____1________
___________________________________________________________________________________________1_1111_111_111111111111111_____________________________________________1111_111111111111_______11111______11___________________________________________________1__111_____1_11__1__1111____________111___________
____1______________________________________________________________________________________11_1111111_111_1111111111_______________________________________________1_11_1_1111111111______11111_____1__________________________________________________111_____11_111_11_11_1111_11____________1_1__________
___________________________________________________________________________________________11111111__111111111111111_______________________________________________111_1111111111111______11111__________________________________________________________1__11__11___11_1____1__1_1____________111__________
_______________________1___________________________________________________________________111_111111111111111111111_______________________________________________11111111111111111______1111________________________________________________________111111__11_11111___1_1__1_1_11____________11__________
___________________________________________________________________________________________1111111111111111111111111______________________________________________1_11_1__1111111111______1111________________________________________________________111____111____1111_111___11_11________________________
___________________________________________________________________________________________111111111_1111111111111_________________________________________________111_1111111111111______1111_______________________________________________________1_11_111_11__1__1_11111__1____1________________________
__________________________1________________________________________________________________1111111111111111111111__________________________________________________1_11_111111111111______1111_________________________________________________________11_111_111_11_1_1__1111111__11_______________________
___________________________________________________________________________________________11111111111111111111_________________________________________________________111111111111______1111_______________________________________________________1_1111111_11_____1__111_111__1_1_______________________
____________________________________________________________________________________________1_11111111111111111____________________________________________________11_1111111111111_______1111_______________________________________________________1_111_11_11111_111_1_1_111_111111______________________
___________________________________________________________________________________________11_1111111111111111_____________________________________________________111_11111111111_________11_________________________________________________________111_1___1_11111111__1_111__11_11______________________
___________________________________________________________________________________________11_1111111111111111_______________________________________________________111_111111111____________________________________________________________________1__1111__1_1_1_11111_11__1_1__11______________________
___________________________________________________________________________________________1111111111111111111_____________________________________________________111__1111111111___________________________________________________________________11111___11__1_11_1____1_1____1111______________________
__________________________________________________________________________________________11111111111111111111_____________________________________________________1_11_1111111111_____________________________________________________________________1111111_111_111_1_1___111__1111______________________
__________________________________________________________________________________________11__1111111111111111__________________________________________________________1_11111111____________________________________________________________________11111___1__1_1_1_1___11_11_11111______________________
__________________________________________________________________________________________11_11111111111111111______________________________________________________1111111111111____________________________________________________________________1__1_1_1__11_1__11_111_111_____11______________________
__________________________________________________________________________________________11_1111111111111111________________________________________________________111111111111____________________________________________________________________1___1111_111_1_1111__111_1_111111______________________
__________________________________________________________________________________________11_1111111111111111_______________________________________________________1_1O1_1111111_____________________________________________________________________1_1____1_111__1_1_1_111____1_111______________________
__________________________________________________________________________________________1111111111111111111_______________________________________________________1_11_1111111______________________________________________________________________1_11___1_1__11_1111_111_1__11111______________________
__________________________________________________________________________________________1111111111111111111_________________________________________________________1_1__11111______________________________________________________________________1_1____11111____111____111__1111______________________
__________________________________________________________________________________________111111111111111111_________________________________________________________111_1111111______________________________________________________________________111___111111_1__1_1111____111111______________________
__________________________________________________________________________________________11111111111111111__________________________________________________________1_1_1_1111_______________________________________________________________________1111_11111_______111_11111111111____1_________________
__________________________________________________________________________________________11111111111111111__________________________________________________________1__1_11111_______________________________________________________________________1__1_1_1_________111_111_1_11111______________________
__________________________________________________________________________________________1111111111111111___________________________________________________________1111_1111________________________________________________________________________1111_11__________1111__11_11111_______________________
__________________________________________________________________________________________1111111111111111___________________________________________________________11111111________________________________________________________________________111_1111__________1111__1__11111_______________________
__________________________________________________________________________________________1111111111111111___________________________________________________________1111111_________________________________________________________________________1111_______________11_11__1_1111_______________________
__________________________________________________________________________________________1111111111111111___________________________________________________________111_____________________________________________________________________________1111_______________11_11_1111_1__________________1_____
_________________________________________________________________________________________1111111111111111______________________________________________________________________________________________________________________________________________11_______________11111__11111__________________1_____
_________________________________________________________________________________________11111111111111__________________________________________________________________________________________________________________________________________________________________11_11111111__________________11____
_________________________________________________________________________________________111_1111111111_____________________________________________________________________________________________________________________________________________________________________11111111__________________11____
_________________________________________________________________________________________11111_11111111____________________________________________________________________________________________________________________________________________________________________1__11111____________________11___
________________________________________________________________________________________111111111111111____________________________________________________________________________________________________________________________________________________________________11111111____________________11___
________________________________________________________________________________________1111_1__1111111____________________________________________________________________________________________________________________________________________________________________11111111____________________111__
________________________________________________________________________________________1111_11_1111111____________________________________________________________________________________________________________________________________________________________________1111111_____________________111__
________________________________________________________________________________________1111111_111111_____________________________________________________________________________________________________________________________________________________________________111111______________________1111_
________________________________________________________________________________________1111111_11111__________________________________________________________________________________________________________________________________________________________________________1_______________________1111_
________________________________________________________________________________________111111_1111___________________________________________________________________________________________________________________________________________________________________________________________________1111__
________________________________________________________________________________________1111111__11____________________________________________________________________________________________________________________________________________________________________________________________________111__
________________________________________________________________________________________1111111111______________________________________________________________________________________________________________________________________________________________________________________________________1___
________________________________________________________________________________________111__1__11_____________________________________________________________________________________________________________________________________________________________________________111___________________1111___
________________________________________________________________________________________111_11_________________________________________________________________________________________________________________________________________________________________________________111___________________111____
________________________________________________________________________________________111111_1_______________________________________________________________________________________________________________________________________________________________________________11___________________111_____
________________________________________________________________________________________11111_111_______________________________________________________________________________________________________________________________________________________________________________11__________________11______
________________________________________________________________________________________111111111_______________________________________________________________________________________________________________________________________________________________________________11__________________________
________________________________________________________________________________________1_1__111_______________________________________________________________________________________________________________________________________________________________________________111___________________1______
_______________________________________________________________________________________11_1____1________________________________________________________________________________________________________________________________________________________________________________1___________________111_____
____________________________________________________________________________________________1_______________________________________________________________________________________________________________________________________________________________________________________________________1_______
_________________________________________________________________________________________1_1111___________________________________________________________________________________________________________________________________________________________________________________________________1_1_______
_________________________________________________________________________________________11_111___________________________________________________________________________________________________________________________________________________________________________________________________111_______
_________________________________________________________________________________________111_1____________________________________________________________________________________________________________________________________________________________________________________________________111_______
_________________________________________________________________________________________111_1___________________________________________________________________________________________________________________________________________________________________________________________________1111_______
___________________________________________________________________________________________1_____________________________________________________________________________________________________________________________________________________________________________________________________111________
_________________________________________________________________________________________11_1_______________________________________________________________________________________________________________________________________________________________________________________________________________
_________________________________________________________________________________________1111_______________________________________________________________________________________________________________________________________________________________________________________________________________
_________________________________________________________________________________________1__1_1_____________________________________________________________________________________________________________________________________________________________________________________________________________
_________________________________________________________________________________________11111______________________________________________________________________________________________________________________________________________________________________________________________________________
_________________________________________________________________________________________11_________________________________________________________________________________________________________________________________________________________________________________________________________________
________________________________________________________________________________________1___1_______________________________________________________________________________________________________________________________________________________________________________________________________________
___________________________________________________________________________________________1________________________________________________________________________________________________________________________________________________________________________________________________________________
____________________________________________________________________________________________________________________________________________________________________________________________________________________________________________________________________________________________________________
__________________________________________________________________________________________11________________________________________________________________________________________________________________________________________________________________________________________________________________
_________________________________________________________________________________________1111_______________________________________________________________________________________________________________________________________________________________________________________________________________
_________________________________________________________________________________________1111_______________________________________________________________________________________________________________________________________________________________________________________________________________
_________________________________________________________________________________________1111_______________________________________________________________________________________________________________________________________________________________________________________________________________
_________________________________________________________________________________________1111_______________________________________________________________________________________________________________________________________________________________________________________________________________
___________________________________________________________________________________________11_______________________________________________________________________________________________________________________________________________________________________________________________________________
____________________________________________________________________________________________________________________________________________________________________________________________________________________________________________________________________________________________________________
____________________________________________________________________________________________1_______________________________________________________________________________________________________________________________________________________________________________________________________________
